NO textures/magic_cub/yellow.xpm



            SO textures/magic_cub/blue.xpm

    WE textures/magic_cub/red.xpm
EA textures/magic_cub/green.xpm


C 246,40,40
F 255,255,255






11111111111111111111111111111
10000000000000000000000010001
11111111111111111000100100001
100000000000000000101100100001
10101111111111111100100000001
10000000011000001N00101110001
100000001000000011010101010001  
10001000000111111110001010001
10001110000000000100000010001
11111111111111111101111111101
11110000000000000000000000001            
    111111111111110000000000011111111111111111
    111111111111111111111111000000000000000001
    111111111111111111110000000000000000000011
    111111111111111111111111111110000000000111
    111111111111111111111111111100100000110011
    111111111111111111111111111111111111111111